0 0 0 0 0 0 0 0
0 0 0 1 1 0 0 0
0 0 1 1 5 1 0 0
0 11 1 5 1 4 1 0
0 1 4 1 3 1 1 0
0 0 1 3 1 1 0 0
0 0 0 1 1 0 0 0
0 0 0 0 0 0 0 0