0 0 0 0 0
0 1 5 5 0
0 5 1 1 0
0 11 3 1 0
0 3 1 3 0
0 0 0 0 0